1111111111111
1C0000P0000E1
1000000000001
1000000000001
1111111111111