111111111111111
100000000000001
100000C000C0001
100P000000E0001
111111111111111
