111111111111111
100000000E00001
111111111111111
100P00C00C00001
111111111111111
