111111111111111
100000001E10001
100000000100001
100P00C00C00001
111111111111111
