11111111111111111111111111111
10000000000000000000000000001
10000000000000000000C000C0001
100P0000000000000000000000001
11111111111111111111111111111
