11111111111111111111111111111
10000000011000000000000000001
10000000110000000000C000C0000
100P0000000001100000000000001
11111111111111111111111111111
