111111111111111
100000000000001
100000C000C0001
100P00000000001
111111111111111
