11111111111111111111111111111
1000E00000000000000000CC00001
10000000000000000000000000001
1P000000000000000000000000001
1000C000000000000000000000001
10000000000000000000000000001
100000000000001100000000E0001
100000000001111100000000E0001
10000000000000000000000000001
11111111111111111111111111111
