1111111111111111111111111111111111
1000000000000000000000C00000000001
1000000000000010000000000000000001
1P00000000000011000000000000C00001
10000000000000100000C0000000000001
1111111111111111111111111111111111
1000000000000010110000000000000001
100000000001111100000000E000000001
10000000000C0000000000000000000001
1111111111111111111111111111111111
