111111111111111
100000000000001
100000C0000C000
100P00000000001
111111111111111
